"","Name","Genes (tot)","Stat (dist.dir)","Genes (up)","Genes (down)","p","fdr"
"1","REACTOME_IMMUNE_SYSTEM",735,0.53289,528,207,0.001007,0.0357038103448276
"2","REACTOME_ADAPTIVE_IMMUNE_SYSTEM",448,0.45596,310,138,0.0010267,0.0357038103448276
"3","REACTOME_SIGNALING_BY_GPCR",299,0.49842,218,81,0.0010582,0.0357038103448276
"4","REACTOME_HEMOSTASIS",341,0.40132,214,127,0.0010627,0.0357038103448276
"5","REACTOME_METABOLISM_OF_LIPIDS_AND_LIPOPROTEINS",355,0.38868,207,148,0.0010764,0.0357038103448276
"6","REACTOME_GPCR_DOWNSTREAM_SIGNALING",236,0.51409,167,69,0.0010881,0.0357038103448276
"7","REACTOME_CYTOKINE_SIGNALING_IN_IMMUNE_SYSTEM",217,0.56903,157,60,0.0011136,0.0357038103448276
"8","REACTOME_INNATE_IMMUNE_SYSTEM",187,0.63186,149,38,0.0011351,0.0357038103448276
"9","REACTOME_PLATELET_ACTIVATION_SIGNALING_AND_AGGREGATION",160,0.50031,113,47,0.001139,0.0357038103448276
"10","REACTOME_GPCR_LIGAND_BINDING",149,0.54462,102,47,0.0011601,0.0357038103448276
"11","REACTOME_TOLL_RECEPTOR_CASCADES",106,0.60769,87,19,0.0012019,0.0357038103448276
"12","REACTOME_INTERFERON_SIGNALING",123,0.60603,90,33,0.001224,0.0357038103448276
"13","REACTOME_CLASS_A1_RHODOPSIN_LIKE_RECEPTORS",105,0.60338,76,29,0.0012255,0.0357038103448276
"14","REACTOME_MYD88_MAL_CASCADE_INITIATED_ON_PLASMA_MEMBRANE",77,0.56161,62,15,0.0012563,0.0357038103448276
"15","REACTOME_SIGNALING_BY_ILS",95,0.56195,72,23,0.001261,0.0357038103448276
"16","REACTOME_ACTIVATED_TLR4_SIGNALLING",86,0.57375,69,17,0.0012706,0.0357038103448276
"17","REACTOME_G_ALPHA_I_SIGNALLING_EVENTS",89,0.59803,67,22,0.0012723,0.0357038103448276
"18","REACTOME_TRANSCRIPTIONAL_REGULATION_OF_WHITE_ADIPOCYTE_DIFFERENTIATION",60,0.61636,38,22,0.001328,0.0357038103448276
"19","REACTOME_PEPTIDE_LIGAND_BINDING_RECEPTORS",56,0.60396,44,12,0.0013387,0.0357038103448276
"20","REACTOME_COSTIMULATION_BY_THE_CD28_FAMILY",54,0.61171,43,11,0.0013532,0.0357038103448276
"21","REACTOME_INTERFERON_GAMMA_SIGNALING",42,0.75717,40,2,0.0013587,0.0357038103448276
"22","REACTOME_NUCLEOTIDE_BINDING_DOMAIN_LEUCINE_RICH_REPEAT_CONTAINING_RECEPTOR_NLR_SIGNALING_PATHWAYS",42,0.61091,27,15,0.0013587,0.0357038103448276
"23","REACTOME_IMMUNOREGULATORY_INTERACTIONS_BETWEEN_A_LYMPHOID_AND_A_NON_LYMPHOID_CELL",45,0.7263,39,6,0.0013928,0.0357038103448276
"24","REACTOME_INTERFERON_ALPHA_BETA_SIGNALING",43,0.72396,40,3,0.0014045,0.0357038103448276
"25","REACTOME_TCR_SIGNALING",43,0.59436,31,12,0.0014045,0.0357038103448276
"26","REACTOME_GPVI_MEDIATED_ACTIVATION_CASCADE",28,0.66568,23,5,0.0014771,0.0357038103448276
"27","REACTOME_CHEMOKINE_RECEPTORS_BIND_CHEMOKINES",25,0.74963,23,2,0.0014859,0.0357038103448276
"28","REACTOME_LATENT_INFECTION_OF_HOMO_SAPIENS_WITH_MYCOBACTERIUM_TUBERCULOSIS",23,0.72561,22,1,0.0015314,0.0357038103448276
"29","REACTOME_COMPLEMENT_CASCADE",14,0.76192,11,3,0.0015385,0.0357038103448276
"30","REACTOME_INITIAL_TRIGGERING_OF_COMPLEMENT",8,0.89514,6,2,0.0017182,0.0385449533333333
"31","REACTOME_CREATION_OF_C4_AND_C2_ACTIVATORS",5,0.94786,3,2,0.0019342,0.0419908580645161
"32","REACTOME_GASTRIN_CREB_SIGNALLING_PATHWAY_VIA_PKC_AND_MAPK",104,0.46922,73,31,0.0024301,0.049785175
"33","REACTOME_RESPIRATORY_ELECTRON_TRANSPORT_ATP_SYNTHESIS_BY_CHEMIOSMOTIC_COUPLING_AND_HEAT_PRODUCTION_BY_UNCOUPLING_PROTEINS_",78,0.53137,62,16,0.0025575,0.049785175
"34","REACTOME_RESPONSE_TO_ELEVATED_PLATELET_CYTOSOLIC_CA2_",63,0.55762,42,21,0.0025806,0.049785175
"35","REACTOME_NFKB_AND_MAP_KINASES_ACTIVATION_MEDIATED_BY_TLR4_SIGNALING_REPERTOIRE",67,0.55558,52,15,0.0026178,0.049785175
"36","REACTOME_TRAF6_MEDIATED_INDUCTION_OF_NFKB_AND_MAP_KINASES_UPON_TLR7_8_OR_9_ACTIVATION",70,0.55071,55,15,0.0026631,0.049785175
"37","REACTOME_IL1_SIGNALING",36,0.68073,26,10,0.0028409,0.0511869631578947
"38","REACTOME_ACTIVATION_OF_THE_PRE_REPLICATIVE_COMPLEX",29,-0.64241,1,28,0.0028902,0.0511869631578947
"39","REACTOME_THE_ROLE_OF_NEF_IN_HIV1_REPLICATION_AND_DISEASE_PATHOGENESIS",25,0.67388,23,2,0.0029718,0.0512826
"40","REACTOME_INFLAMMASOMES",15,0.75695,10,5,0.0031596,0.0524431146341463
"41","REACTOME_TRAF6_MEDIATED_INDUCTION_OF_TAK1_COMPLEX",13,0.77213,7,6,0.0031949,0.0524431146341463
"42","REACTOME_ACTIVATION_OF_ATR_IN_RESPONSE_TO_REPLICATION_STRESS",35,-0.57811,5,30,0.0032895,0.0526974651162791
"43","REACTOME_PHOSPHORYLATION_OF_CD3_AND_TCR_ZETA_CHAINS",9,0.83059,9,0,0.003367,0.0526974651162791
"44","REACTOME_RESPIRATORY_ELECTRON_TRANSPORT",63,0.5334,51,12,0.003871,0.057076252173913
"45","REACTOME_ANTIGEN_PROCESSING_CROSS_PRESENTATION",62,0.53776,50,12,0.0038911,0.057076252173913
"46","REACTOME_CELL_SURFACE_INTERACTIONS_AT_THE_VASCULAR_WALL",66,0.544,45,21,0.0039012,0.057076252173913
"47","REACTOME_TRANSMEMBRANE_TRANSPORT_OF_SMALL_MOLECULES",252,0.39716,129,123,0.004315,0.0617871276595745
"48","REACTOME_GENERATION_OF_SECOND_MESSENGER_MOLECULES",20,0.71338,17,3,0.0044313,0.06213051875
"49","REACTOME_PEPTIDE_CHAIN_ELONGATION",81,-0.47633,9,72,0.0047393,0.0650928346938776
"50","REACTOME_PD1_SIGNALING",11,0.81654,11,0,0.0049261,0.066305306
"51","REACTOME_3_UTR_MEDIATED_TRANSLATIONAL_REGULATION",101,-0.42694,18,83,0.005291,0.0698204509803921
"52","REACTOME_SIGNALING_BY_THE_B_CELL_RECEPTOR_BCR",115,0.4457,88,27,0.0059172,0.0765822230769231
"53","REACTOME_TRANSLOCATION_OF_ZAP_70_TO_IMMUNOLOGICAL_SYNAPSE",7,0.82843,7,0,0.0088496,0.112373222641509
"54","REACTOME_GLYCOSPHINGOLIPID_METABOLISM",26,0.61731,21,5,0.0090361,0.11261657962963
"55","REACTOME_TCA_CYCLE_AND_RESPIRATORY_ELECTRON_TRANSPORT",113,0.44145,82,31,0.0096735,0.117821869642857
"56","REACTOME_INFLUENZA_VIRAL_RNA_TRANSCRIPTION_AND_REPLICATION",97,-0.37508,16,81,0.0098039,0.117821869642857
"57","REACTOME_NUCLEAR_RECEPTOR_TRANSCRIPTION_PATHWAY",30,0.59314,19,11,0.0099857,0.117901335087719
"58","REACTOME_G2_M_CHECKPOINTS",41,-0.48231,8,33,0.010204,0.117946101694915
"59","REACTOME_CIRCADIAN_REPRESSION_OF_EXPRESSION_BY_REV_ERBA",20,0.66468,15,5,0.01034,0.117946101694915
"60","REACTOME_NEF_MEDIATES_DOWN_MODULATION_OF_CELL_SURFACE_RECEPTORS_BY_RECRUITING_THEM_TO_CLATHRIN_ADAPTERS",18,0.67523,17,1,0.010989,0.120394523076923
"61","REACTOME_NONSENSE_MEDIATED_DECAY_ENHANCED_BY_THE_EXON_JUNCTION_COMPLEX",99,-0.4285,17,82,0.01105,0.120394523076923
"62","REACTOME_SIGNAL_REGULATORY_PROTEIN_SIRP_FAMILY_INTERACTIONS",12,0.75911,11,1,0.011236,0.120394523076923
"63","REACTOME_G_ALPHA_Q_SIGNALLING_EVENTS",85,0.46674,56,29,0.01148,0.120394523076923
"64","REACTOME_PHOSPHOLIPID_METABOLISM",154,0.42187,97,57,0.011521,0.120394523076923
"65","REACTOME_TRIF_MEDIATED_TLR3_SIGNALING",68,0.49549,52,16,0.011628,0.120394523076923
"66","REACTOME_THE_NLRP3_INFLAMMASOME",10,0.75843,7,3,0.012007,0.12080852238806
"67","REACTOME_TRAF6_MEDIATED_IRF7_ACTIVATION_IN_TLR7_8_OR_9_SIGNALING",8,0.80162,7,1,0.012027,0.12080852238806
"68","REACTOME_GENERIC_TRANSCRIPTION_PATHWAY",291,-0.39913,71,220,0.013514,0.133748852941176
"69","REACTOME_TRANSPORT_OF_GLUCOSE_AND_OTHER_SUGARS_BILE_SALTS_AND_ORGANIC_ACIDS_METAL_IONS_AND_AMINE_COMPOUNDS",44,0.5322,22,22,0.014025,0.136794565217391
"70","REACTOME_PPARA_ACTIVATES_GENE_EXPRESSION",83,0.46551,47,36,0.014323,0.137705414285714
"71","REACTOME_ENDOGENOUS_STEROLS",5,0.87013,4,1,0.015474,0.146676084507042
"72","REACTOME_TIGHT_JUNCTION_INTERACTIONS",13,-0.66355,2,11,0.015957,0.1479842875
"73","REACTOME_RIG_I_MDA5_MEDIATED_INDUCTION_OF_IFN_ALPHA_BETA_PATHWAYS",55,0.51378,39,16,0.016216,0.1479842875
"74","REACTOME_FGFR_LIGAND_BINDING_AND_ACTIVATION",5,-0.82782,1,4,0.016495,0.1479842875
"75","REACTOME_TAK1_ACTIVATES_NFKB_BY_PHOSPHORYLATION_AND_ACTIVATION_OF_IKKS_COMPLEX",21,0.64112,13,8,0.01682,0.1479842875
"76","REACTOME_IKK_COMPLEX_RECRUITMENT_MEDIATED_BY_RIP1",9,0.77319,7,2,0.016835,0.1479842875
"77","REACTOME_INTEGRIN_ALPHAIIB_BETA3_SIGNALING",22,0.61933,18,4,0.017054,0.1479842875
"78","REACTOME_SLC_MEDIATED_TRANSMEMBRANE_TRANSPORT",149,0.41568,68,81,0.017401,0.1479842875
"79","REACTOME_DEFENSINS",5,0.86578,5,0,0.017408,0.1479842875
"80","REACTOME_SPHINGOLIPID_METABOLISM",48,0.51515,34,14,0.017591,0.1479842875
"81","REACTOME_CLASS_C_3_METABOTROPIC_GLUTAMATE_PHEROMONE_RECEPTORS",2,0.96573,2,0,0.018443,0.153236283950617
"82","REACTOME_MITOCHONDRIAL_TRNA_AMINOACYLATION",21,-0.57602,4,17,0.020115,0.164909035714286
"83","REACTOME_NEURONAL_SYSTEM",142,0.42215,87,55,0.020525,0.164909035714286
"84","REACTOME_TRAFFICKING_AND_PROCESSING_OF_ENDOSOMAL_TLR",10,0.74688,9,1,0.020583,0.164909035714286
"85","REACTOME_CS_DS_DEGRADATION",7,0.79708,6,1,0.021239,0.167522220930233
"86","REACTOME_INSULIN_RECEPTOR_RECYCLING",17,0.66035,16,1,0.021407,0.167522220930233
"87","REACTOME_IRON_UPTAKE_AND_TRANSPORT",28,0.58931,22,6,0.022157,0.171398402298851
"88","REACTOME_BOTULINUM_NEUROTOXICITY",16,0.65611,16,0,0.023585,0.178243688172043
"89","REACTOME_ANTIGEN_ACTIVATES_B_CELL_RECEPTOR_LEADING_TO_GENERATION_OF_SECOND_MESSENGERS",27,0.57602,23,4,0.023988,0.178243688172043
"90","REACTOME_INFLUENZA_LIFE_CYCLE",131,-0.33859,28,103,0.024242,0.178243688172043
"91","REACTOME_PI3K_EVENTS_IN_ERBB4_SIGNALING",33,0.56179,21,12,0.024531,0.178243688172043
"92","REACTOME_CELL_CELL_JUNCTION_ORGANIZATION",28,-0.49199,8,20,0.024615,0.178243688172043
"93","REACTOME_CD28_DEPENDENT_VAV1_PATHWAY",11,0.73382,10,1,0.024631,0.178243688172043
"94","REACTOME_RORA_ACTIVATES_CIRCADIAN_EXPRESSION",21,0.61024,15,6,0.025994,0.18379209375
"95","REACTOME_REGULATION_OF_INSULIN_LIKE_GROWTH_FACTOR_IGF_ACTIVITY_BY_INSULIN_LIKE_GROWTH_FACTOR_BINDING_PROTEINS_IGFBPS",6,-0.78623,3,3,0.026128,0.18379209375
"96","REACTOME_TRANSPORT_OF_ORGANIC_ANIONS",4,0.88089,3,1,0.026217,0.18379209375
"97","REACTOME_SIGNALING_BY_ERBB4",72,0.45416,48,24,0.026752,0.185609237113402
"98","REACTOME_CREB_PHOSPHORYLATION_THROUGH_THE_ACTIVATION_OF_CAMKII",8,0.74234,6,2,0.027491,0.186978434343434
"99","REACTOME_ENDOSOMAL_VACUOLAR_PATHWAY",3,0.91061,3,0,0.027505,0.186978434343434
"100","REACTOME_SIGNALLING_BY_NGF",190,0.38386,138,52,0.028249,0.188699871287129
"101","REACTOME_PYRIMIDINE_CATABOLISM",7,0.78809,4,3,0.028319,0.188699871287129
"102","REACTOME_METABOLISM_OF_CARBOHYDRATES",178,0.38675,106,72,0.028825,0.188779766990291
"103","REACTOME_CHONDROITIN_SULFATE_BIOSYNTHESIS",12,0.71191,8,4,0.028892,0.188779766990291
"104","REACTOME_HEPARAN_SULFATE_HEPARIN_HS_GAG_METABOLISM",34,0.53785,18,16,0.029851,0.193170413461538
"105","REACTOME_TETRAHYDROBIOPTERIN_BH4_SYNTHESIS_RECYCLING_SALVAGE_AND_REGULATION",12,0.70846,9,3,0.030498,0.195477657142857
"106","REACTOME_FATTY_ACID_TRIACYLGLYCEROL_AND_KETONE_BODY_METABOLISM",139,0.40706,79,60,0.031288,0.198649283018868
"107","REACTOME_VOLTAGE_GATED_POTASSIUM_CHANNELS",13,0.70187,6,7,0.031949,0.20004925
"108","REACTOME_ACTIVATION_OF_IRF3_IRF7_MEDIATED_BY_TBK1_IKK_EPSILON",12,0.70345,9,3,0.032103,0.20004925
"109","REACTOME_CD28_CO_STIMULATION",30,0.55827,22,8,0.03281,0.202579174311927
"110","REACTOME_METABOLISM_OF_PORPHYRINS",13,0.70057,6,7,0.033546,0.203391513513514
"111","REACTOME_NUCLEOTIDE_LIKE_PURINERGIC_RECEPTORS",13,0.6994,9,4,0.033546,0.203391513513514
"112","REACTOME_ACYL_CHAIN_REMODELLING_OF_PI",6,0.81831,4,2,0.034423,0.206845348214286
"113","REACTOME_BINDING_AND_ENTRY_OF_HIV_VIRION",4,0.86832,4,0,0.035581,0.211911619469027
"114","REACTOME_BETA_DEFENSINS",4,0.8657,4,0,0.037453,0.221104114035088
"115","REACTOME_ACTIVATED_POINT_MUTANTS_OF_FGFR2",3,-0.87755,1,2,0.03854,0.224648560344828
"116","REACTOME_DOWNREGULATION_OF_ERBB2_ERBB3_SIGNALING",9,0.72878,5,4,0.038721,0.224648560344828
"117","REACTOME_REGULATION_OF_IFNG_SIGNALING",13,0.68664,13,0,0.039936,0.229550033898305
"118","REACTOME_PYRIMIDINE_METABOLISM",19,0.60769,7,12,0.040248,0.229550033898305
"119","REACTOME_TRANS_GOLGI_NETWORK_VESICLE_BUDDING",53,0.4726,39,14,0.040816,0.230833344537815
"120","REACTOME_EARLY_PHASE_OF_HIV_LIFE_CYCLE",13,0.68256,6,7,0.041534,0.232936516666667
"121","REACTOME_SIGNALING_BY_RHO_GTPASES",95,0.42186,61,34,0.042875,0.238470041322314
"122","REACTOME_GLYCOSAMINOGLYCAN_METABOLISM",73,0.44791,43,30,0.045045,0.247756266129032
"123","REACTOME_SIGNALING_BY_EGFR_IN_CANCER",95,0.42064,69,26,0.045397,0.247756266129032
"124","REACTOME_MUSCLE_CONTRACTION",30,0.5407,23,7,0.045649,0.247756266129032
"125","REACTOME_AMINO_ACID_SYNTHESIS_AND_INTERCONVERSION_TRANSAMINATION",16,-0.56488,4,12,0.046448,0.248769642857143
"126","REACTOME_MYOGENESIS",18,-0.56261,9,9,0.046575,0.248769642857143
"127","REACTOME_P130CAS_LINKAGE_TO_MAPK_SIGNALING_FOR_INTEGRINS",11,0.68732,9,2,0.049261,0.261044511811024
"128","REACTOME_NGF_SIGNALLING_VIA_TRKA_FROM_THE_PLASMA_MEMBRANE",120,0.39559,91,29,0.050119,0.2635163046875
"129","REACTOME_UNWINDING_OF_DNA",11,-0.62316,0,11,0.050891,0.264617435114504
"130","REACTOME_FGFR1_LIGAND_BINDING_AND_ACTIVATION",4,-0.82581,1,3,0.051282,0.264617435114504
"131","REACTOME_TRANSMISSION_ACROSS_CHEMICAL_SYNAPSES",102,0.41404,61,41,0.051508,0.264617435114504
"132","REACTOME_XENOBIOTICS",3,-0.85892,0,3,0.052738,0.268883893939394
"133","REACTOME_DOWNSTREAM_SIGNAL_TRANSDUCTION",82,0.41682,57,25,0.054847,0.275432565217391
"134","REACTOME_SIGNALING_BY_FGFR_MUTANTS",28,-0.45059,11,17,0.055385,0.275432565217391
"135","REACTOME_POTASSIUM_CHANNELS",39,0.49488,21,18,0.055394,0.275432565217391
"136","REACTOME_TRANSFERRIN_ENDOCYTOSIS_AND_RECYCLING",19,0.58252,16,3,0.055728,0.275432565217391
"137","REACTOME_ADVANCED_GLYCOSYLATION_ENDPRODUCT_RECEPTOR_SIGNALING",12,0.67467,10,2,0.05618,0.275432565217391
"138","REACTOME_DNA_STRAND_ELONGATION",30,-0.43001,4,26,0.056478,0.275432565217391
"139","REACTOME_CHONDROITIN_SULFATE_DERMATAN_SULFATE_METABOLISM",36,0.5076,18,18,0.058239,0.279237723404255
"140","REACTOME_RNA_POL_I_TRANSCRIPTION_TERMINATION",20,-0.50226,3,17,0.058462,0.279237723404255
"141","REACTOME_SIGNALING_BY_WNT",59,0.46205,47,12,0.058503,0.279237723404255
"142","REACTOME_UNBLOCKING_OF_NMDA_RECEPTOR_GLUTAMATE_BINDING_AND_ACTIVATION",4,0.84073,3,1,0.059925,0.280794165517241
"143","REACTOME_REGULATED_PROTEOLYSIS_OF_P75NTR",10,0.6705,9,1,0.060034,0.280794165517241
"144","REACTOME_IL_6_SIGNALING",8,0.71597,8,0,0.060137,0.280794165517241
"145","REACTOME_FORMATION_OF_THE_TERNARY_COMPLEX_AND_SUBSEQUENTLY_THE_43S_COMPLEX",46,-0.40567,8,38,0.060498,0.280794165517241
"146","REACTOME_GLYCEROPHOSPHOLIPID_BIOSYNTHESIS",64,0.43471,37,27,0.062581,0.288472691780822
"147","REACTOME_SIGNALING_BY_FGFR3_MUTANTS",3,-0.83322,1,2,0.064909,0.297168414965986
"148","REACTOME_PI3K_EVENTS_IN_ERBB2_SIGNALING",37,0.48982,22,15,0.067321,0.305564583892617
"149","REACTOME_MEMBRANE_TRAFFICKING",101,0.40385,77,24,0.067651,0.305564583892617
"150","REACTOME_CTLA4_INHIBITORY_SIGNALING",21,0.56367,16,5,0.068807,0.308714073333333
"151","REACTOME_ACTIVATION_OF_NF_KAPPAB_IN_B_CELLS",57,0.44421,44,13,0.069705,0.310671953642384
"152","REACTOME_DEPOSITION_OF_NEW_CENPA_CONTAINING_NUCLEOSOMES_AT_THE_CENTROMERE",31,-0.43297,8,23,0.07074,0.313210657894737
"153","REACTOME_G_ALPHA_S_SIGNALLING_EVENTS",59,0.45416,39,20,0.072109,0.317185339869281
"154","REACTOME_NUCLEAR_SIGNALING_BY_ERBB4",25,0.53542,15,10,0.072808,0.317527401273885
"155","REACTOME_P2Y_RECEPTORS",10,0.65695,6,4,0.073756,0.317527401273885
"156","REACTOME_PROTEOLYTIC_CLEAVAGE_OF_SNARE_COMPLEX_PROTEINS",14,0.64564,14,0,0.073846,0.317527401273885
"157","REACTOME_MAP_KINASE_ACTIVATION_IN_TLR_CASCADE",47,0.48105,37,10,0.074074,0.317527401273885
"158","REACTOME_NEUROTRANSMITTER_RECEPTOR_BINDING_AND_DOWNSTREAM_TRANSMISSION_IN_THE_POSTSYNAPTIC_CELL",73,0.42937,47,26,0.074646,0.317954164556962
"159","REACTOME_CD28_DEPENDENT_PI3K_AKT_SIGNALING",20,0.5717,13,7,0.076809,0.32510979245283
"160","REACTOME_REGULATION_OF_GENE_EXPRESSION_IN_BETA_CELLS",5,0.78038,3,2,0.077369,0.32543335625
"161","REACTOME_DOWNSTREAM_SIGNALING_EVENTS_OF_B_CELL_RECEPTOR_BCR",88,0.41134,65,23,0.078261,0.327140701863354
"162","REACTOME_PLATELET_AGGREGATION_PLUG_FORMATION",27,0.52251,20,7,0.07946,0.330102345679012
"163","REACTOME_CREB_PHOSPHORYLATION_THROUGH_THE_ACTIVATION_OF_RAS",19,0.56208,15,4,0.080495,0.332350521472393
"164","REACTOME_ER_PHAGOSOME_PATHWAY",50,0.44572,40,10,0.082287,0.33767775
"165","REACTOME_VIF_MEDIATED_DEGRADATION_OF_APOBEC3G",46,0.46841,37,9,0.084605,0.345085848484849
"166","REACTOME_SIGNALING_BY_SCF_KIT",72,0.41328,50,22,0.086624,0.349867311377246
"167","REACTOME_APOPTOTIC_CLEAVAGE_OF_CELLULAR_PROTEINS",31,-0.4216,17,14,0.086817,0.349867311377246
"168","REACTOME_REGULATION_OF_ORNITHINE_DECARBOXYLASE_ODC",45,0.45641,36,9,0.089136,0.355320106508876
"169","REACTOME_PROLACTIN_RECEPTOR_SIGNALING",9,0.68495,4,5,0.089226,0.355320106508876
"170","REACTOME_DOWNSTREAM_TCR_SIGNALING",26,0.51895,17,9,0.091867,0.361900830409357
"171","REACTOME_REGULATION_OF_IFNA_SIGNALING",11,0.65387,11,0,0.091954,0.361900830409357
"172","REACTOME_PLATELET_SENSITIZATION_BY_LDL",14,0.62938,11,3,0.093846,0.364468977653631
"173","REACTOME_CELL_JUNCTION_ORGANIZATION",42,-0.38761,20,22,0.093985,0.364468977653631
"174","REACTOME_REGULATION_OF_SIGNALING_BY_CBL",17,0.57193,13,4,0.094801,0.364468977653631
"175","REACTOME_FACILITATIVE_NA_INDEPENDENT_GLUCOSE_TRANSPORTERS",9,0.67833,6,3,0.09596,0.364468977653631
"176","REACTOME_GRB2_SOS_PROVIDES_LINKAGE_TO_MAPK_SIGNALING_FOR_INTERGRINS_",12,0.64385,9,3,0.096308,0.364468977653631
"177","REACTOME_ACTIVATION_OF_NMDA_RECEPTOR_UPON_GLUTAMATE_BINDING_AND_POSTSYNAPTIC_EVENTS",23,0.54629,18,5,0.096478,0.364468977653631
"178","REACTOME_POST_NMDA_RECEPTOR_ACTIVATION_EVENTS",23,0.54629,18,5,0.096478,0.364468977653631
"179","REACTOME_SIGNALING_BY_ERBB2",85,0.39649,58,27,0.096939,0.364468977653631
"180","REACTOME_ACTIVATION_OF_THE_MRNA_UPON_BINDING_OF_THE_CAP_BINDING_COMPLEX_AND_EIFS_AND_SUBSEQUENT_BINDING_TO_43S",54,-0.36078,13,41,0.098859,0.368741137362637
"181","REACTOME_HYALURONAN_UPTAKE_AND_DEGRADATION",8,0.68525,8,0,0.099656,0.368741137362637
"182","REACTOME_ACTIVATION_OF_CHAPERONE_GENES_BY_XBP1S",43,0.46316,28,15,0.099719,0.368741137362637
"183","REACTOME_ANTIGEN_PRESENTATION_FOLDING_ASSEMBLY_AND_PEPTIDE_LOADING_OF_CLASS_I_MHC",15,0.58702,13,2,0.10111,0.371841693989071
"184","REACTOME_CTNNB1_PHOSPHORYLATION_CASCADE",15,0.58628,13,2,0.10427,0.379457446808511
"185","REACTOME_CHOLESTEROL_BIOSYNTHESIS",20,-0.45952,6,14,0.10462,0.379457446808511
"186","REACTOME_TRAFFICKING_OF_AMPA_RECEPTORS",15,0.58436,10,5,0.10585,0.379457446808511
"187","REACTOME_ERKS_ARE_INACTIVATED",12,0.63658,11,1,0.10594,0.379457446808511
"188","REACTOME_P53_DEPENDENT_G1_DNA_DAMAGE_RESPONSE",50,0.4268,40,10,0.106,0.379457446808511
"189","REACTOME_TRAF6_MEDIATED_NFKB_ACTIVATION",19,0.54583,13,6,0.10681,0.380334021164021
"190","REACTOME_HYALURONAN_METABOLISM",10,0.63149,9,1,0.10806,0.381178743455497
"191","REACTOME_GOLGI_ASSOCIATED_VESICLE_BIOGENESIS",46,0.45666,32,14,0.10818,0.381178743455497
"192","REACTOME_TELOMERE_MAINTENANCE",45,-0.37363,10,35,0.10915,0.382593489583333
"193","REACTOME_NOTCH_HLH_TRANSCRIPTION_PATHWAY",11,0.63452,8,3,0.11002,0.383644870466321
"194","REACTOME_TRAFFICKING_OF_GLUR2_CONTAINING_AMPA_RECEPTORS",9,0.66714,7,2,0.11111,0.384058666666667
"195","REACTOME_NEGATIVE_REGULATORS_OF_RIG_I_MDA5_SIGNALING",29,0.49334,20,9,0.11128,0.384058666666667
"196","REACTOME_METABOLISM_OF_NON_CODING_RNA",46,-0.36593,14,32,0.11388,0.389315126903553
"197","REACTOME_BILE_ACID_AND_BILE_SALT_METABOLISM",12,0.63153,8,4,0.11396,0.389315126903553
"198","REACTOME_TRNA_AMINOACYLATION",41,-0.37145,10,31,0.11565,0.393093181818182
"199","REACTOME_REGULATION_OF_COMPLEMENT_CASCADE",7,0.70286,6,1,0.11681,0.395040854271357
"200","REACTOME_ION_TRANSPORT_BY_P_TYPE_ATPASES",23,-0.43098,9,14,0.11748,0.3953202
"201","REACTOME_RECYCLING_PATHWAY_OF_L1",24,0.52139,20,4,0.11936,0.39964815920398
"202","REACTOME_SEMA4D_IN_SEMAPHORIN_SIGNALING",25,0.50415,20,5,0.12036,0.401001386138614
"203","REACTOME_TRANSLATION",140,-0.27844,44,96,0.12195,0.404297290640394
"204","REACTOME_PIP3_ACTIVATES_AKT_SIGNALING",27,0.49733,18,9,0.12294,0.405474292682927
"205","REACTOME_OPIOID_SIGNALLING",60,0.40703,46,14,0.12351,0.405474292682927
"206","REACTOME_AMINO_ACID_AND_OLIGOPEPTIDE_SLC_TRANSPORTERS",27,0.49686,15,12,0.12444,0.40654427184466
"207","REACTOME_EXTRACELLULAR_MATRIX_ORGANIZATION",48,-0.35286,27,21,0.12548,0.40796154589372
"208","REACTOME_BMAL1_CLOCK_NPAS2_ACTIVATES_CIRCADIAN_EXPRESSION",31,0.4795,21,10,0.12735,0.411332660550459
"209","REACTOME_STRIATED_MUSCLE_CONTRACTION",13,0.60617,10,3,0.1278,0.411332660550459
"210","REACTOME_HOST_INTERACTIONS_OF_HIV_FACTORS",114,0.3696,73,41,0.12979,0.411332660550459
"211","REACTOME_GAB1_SIGNALOSOME",35,0.46446,23,12,0.13037,0.411332660550459
"212","REACTOME_RIP_MEDIATED_NFKB_ACTIVATION_VIA_DAI",16,0.56717,12,4,0.1305,0.411332660550459
"213","REACTOME_INTEGRIN_CELL_SURFACE_INTERACTIONS",57,0.41979,40,17,0.13137,0.411332660550459
"214","REACTOME_TRAF6_MEDIATED_IRF7_ACTIVATION",15,0.57093,10,5,0.1327,0.411332660550459
"215","REACTOME_APOPTOTIC_CLEAVAGE_OF_CELL_ADHESION_PROTEINS",6,-0.69157,3,3,0.13302,0.411332660550459
"216","REACTOME_SHC1_EVENTS_IN_ERBB4_SIGNALING",17,0.5498,14,3,0.13303,0.411332660550459
"217","REACTOME_CROSS_PRESENTATION_OF_SOLUBLE_EXOGENOUS_ANTIGENS_ENDOSOMES",42,0.44807,34,8,0.13315,0.411332660550459
"218","REACTOME_IL_2_SIGNALING",35,0.46281,28,7,0.13324,0.411332660550459
"219","REACTOME_AKT_PHOSPHORYLATES_TARGETS_IN_THE_CYTOSOL",12,0.61869,10,2,0.13483,0.412824318181818
"220","REACTOME_MEIOTIC_RECOMBINATION",37,-0.37637,10,27,0.13495,0.412824318181818
"221","REACTOME_NEF_MEDIATED_DOWNREGULATION_OF_MHC_CLASS_I_COMPLEX_CELL_SURFACE_EXPRESSION",7,0.69013,7,0,0.13805,0.420396606334842
"222","REACTOME_SEMAPHORIN_INTERACTIONS",53,0.41354,39,14,0.13878,0.420715945945946
"223","REACTOME_AUTODEGRADATION_OF_THE_E3_UBIQUITIN_LIGASE_COP1",44,0.42849,35,9,0.14025,0.423092666666667
"224","REACTOME_CIRCADIAN_CLOCK",47,0.43774,30,17,0.14129,0.423092666666667
"225","REACTOME_RECYCLING_OF_BILE_ACIDS_AND_SALTS",3,0.81401,2,1,0.14145,0.423092666666667
"226","REACTOME_EXTENSION_OF_TELOMERES",26,-0.4198,4,22,0.14497,0.431702699115044
"227","REACTOME_TRANSPORT_OF_INORGANIC_CATIONS_ANIONS_AND_AMINO_ACIDS_OLIGOPEPTIDES",55,0.42368,27,28,0.14595,0.432706387665198
"228","REACTOME_RAF_MAP_KINASE_CASCADE",10,0.60664,10,0,0.15266,0.450614824561403
"229","REACTOME_NEGATIVE_REGULATION_OF_FGFR_SIGNALING",18,-0.45617,11,7,0.15342,0.450676926406926
"230","REACTOME_INTERACTION_BETWEEN_L1_AND_ANKYRINS",13,-0.51937,5,8,0.15426,0.450676926406926
"231","REACTOME_SIGNALING_BY_PDGF",99,0.36589,67,32,0.15469,0.450676926406926
"232","REACTOME_ION_CHANNEL_TRANSPORT",24,-0.44417,9,15,0.15556,0.451258103448276
"233","REACTOME_NOD1_2_SIGNALING_PATHWAY",28,0.47657,18,10,0.15657,0.452170085106383
"234","REACTOME_HS_GAG_DEGRADATION",17,0.53796,10,7,0.15749,0.452170085106383
"235","REACTOME_APOPTOTIC_EXECUTION_PHASE",42,-0.35974,21,21,0.15789,0.452170085106383
"236","REACTOME_DEVELOPMENTAL_BIOLOGY",269,0.32541,165,104,0.15987,0.455900466101695
"237","REACTOME_HOMOLOGOUS_RECOMBINATION_REPAIR_OF_REPLICATION_INDEPENDENT_DOUBLE_STRAND_BREAKS",16,-0.48866,4,12,0.16393,0.462631416666667
"238","REACTOME_CITRIC_ACID_CYCLE_TCA_CYCLE",19,0.51235,15,4,0.16409,0.462631416666667
"239","REACTOME_DESTABILIZATION_OF_MRNA_BY_AUF1_HNRNP_D0",47,0.43043,36,11,0.16461,0.462631416666667
"240","REACTOME_SYNTHESIS_SECRETION_AND_DEACYLATION_OF_GHRELIN",9,0.64017,8,1,0.16498,0.462631416666667
"241","REACTOME_BRANCHED_CHAIN_AMINO_ACID_CATABOLISM",17,-0.47255,2,15,0.16667,0.465200864197531
"242","REACTOME_SRP_DEPENDENT_COTRANSLATIONAL_PROTEIN_TARGETING_TO_MEMBRANE",104,-0.29216,30,74,0.1676,0.465200864197531
"243","REACTOME_A_TETRASACCHARIDE_LINKER_SEQUENCE_IS_REQUIRED_FOR_GAG_SYNTHESIS",18,0.52981,8,10,0.16797,0.465200864197531
"244","REACTOME_SYNTHESIS_OF_GLYCOSYLPHOSPHATIDYLINOSITOL_GPI",15,-0.50701,5,10,0.17073,0.470906926229508
"245","REACTOME_ORGANIC_CATION_ANION_ZWITTERION_TRANSPORT",5,0.72234,3,2,0.17215,0.472885510204082
"246","REACTOME_IRAK1_RECRUITS_IKK_COMPLEX",8,0.63804,6,2,0.17354,0.47476593495935
"247","REACTOME_EFFECTS_OF_PIP2_HYDROLYSIS",17,0.52522,15,2,0.1789,0.482629482071713
"248","REACTOME_SIGNALING_BY_HIPPO",14,-0.48986,5,9,0.17898,0.482629482071713
"249","REACTOME_E2F_ENABLED_INHIBITION_OF_PRE_REPLICATION_COMPLEX_FORMATION",10,-0.55566,1,9,0.179,0.482629482071713
"250","REACTOME_EXTRINSIC_PATHWAY_FOR_APOPTOSIS",12,0.59336,10,2,0.17978,0.482629482071713
"251","REACTOME_JNK_C_JUN_KINASES_PHOSPHORYLATION_AND_ACTIVATION_MEDIATED_BY_ACTIVATED_HUMAN_TAK1",14,0.56153,8,6,0.18,0.482629482071713
"252","REACTOME_PLC_BETA_MEDIATED_EVENTS",33,0.45566,25,8,0.18182,0.485089921259843
"253","REACTOME_AMYLOIDS",27,0.47045,12,15,0.18291,0.485089921259843
"254","REACTOME_SCF_BETA_TRCP_MEDIATED_DEGRADATION_OF_EMI1",46,0.42547,35,11,0.18308,0.485089921259843
"255","REACTOME_NOTCH1_INTRACELLULAR_DOMAIN_REGULATES_TRANSCRIPTION",39,0.42833,24,15,0.18513,0.488598
"256","REACTOME_SHC_RELATED_EVENTS",14,0.55814,13,1,0.18615,0.488618949416342
"257","REACTOME_PYRUVATE_METABOLISM_AND_CITRIC_ACID_TCA_CYCLE",39,0.42773,24,15,0.18659,0.488618949416342
"258","REACTOME_G_PROTEIN_BETA_GAMMA_SIGNALLING",23,0.4749,16,7,0.18989,0.495333217054264
"259","REACTOME_AMINE_DERIVED_HORMONES",2,-0.82455,0,2,0.19066,0.495421544401544
"260","REACTOME_COLLAGEN_FORMATION",32,-0.3877,17,15,0.19231,0.497787038461538
"261","REACTOME_REGULATION_OF_PYRUVATE_DEHYDROGENASE_PDH_COMPLEX",12,0.58204,5,7,0.19583,0.504956283524904
"262","REACTOME_SHC_MEDIATED_CASCADE",11,-0.52104,6,5,0.19847,0.507783598484849
"263","REACTOME_GLYCOLYSIS",23,0.47208,18,5,0.19908,0.507783598484849
"264","REACTOME_SCFSKP2_MEDIATED_DEGRADATION_OF_P27_P21",51,0.40487,39,12,0.19919,0.507783598484849
"265","REACTOME_G_ALPHA1213_SIGNALLING_EVENTS",62,0.37953,41,21,0.20233,0.513841849056604
"266","REACTOME_HIGHLY_CALCIUM_PERMEABLE_POSTSYNAPTIC_NICOTINIC_ACETYLCHOLINE_RECEPTORS",2,-0.81422,0,2,0.20623,0.517686555555556
"267","REACTOME_CA_DEPENDENT_EVENTS",23,0.46808,18,5,0.20674,0.517686555555556
"268","REACTOME_OLFACTORY_SIGNALING_PATHWAY",4,-0.70428,2,2,0.20726,0.517686555555556
"269","REACTOME_REGULATION_OF_MRNA_STABILITY_BY_PROTEINS_THAT_BIND_AU_RICH_ELEMENTS",77,0.36692,50,27,0.20729,0.517686555555556
"270","REACTOME_INHIBITION_OF_VOLTAGE_GATED_CA2_CHANNELS_VIA_GBETA_GAMMA_SUBUNITS",14,0.54421,9,5,0.20769,0.517686555555556
"271","REACTOME_TRIGLYCERIDE_BIOSYNTHESIS",33,0.44581,20,13,0.20924,0.519625535055351
"272","REACTOME_FORMATION_OF_ATP_BY_CHEMIOSMOTIC_COUPLING",13,0.56083,10,3,0.21086,0.521723455882353
"273","REACTOME_G_BETA_GAMMA_SIGNALLING_THROUGH_PI3KGAMMA",20,0.48964,14,6,0.2127,0.524348351648352
"274","REACTOME_ACYL_CHAIN_REMODELLING_OF_PC",12,0.57296,7,5,0.21348,0.524350510948905
"275","REACTOME_LYSOSOME_VESICLE_BIOGENESIS",20,0.48554,17,3,0.21713,0.531376327272727
"276","REACTOME_FATTY_ACYL_COA_BIOSYNTHESIS",15,0.52563,9,6,0.21801,0.531596847826087
"277","REACTOME_ENOS_ACTIVATION_AND_REGULATION",18,0.49803,12,6,0.22135,0.534690176678445
"278","REACTOME_ACYL_CHAIN_REMODELLING_OF_PE",11,0.58017,7,4,0.22167,0.534690176678445
"279","REACTOME_METABOLISM_OF_NUCLEOTIDES",60,0.37833,22,38,0.22178,0.534690176678445
"280","REACTOME_CASPASE_MEDIATED_CLEAVAGE_OF_CYTOSKELETAL_PROTEINS",11,-0.51083,5,6,0.22392,0.534690176678445
"281","REACTOME_MRNA_3_END_PROCESSING",32,-0.37226,8,24,0.22436,0.534690176678445
"282","REACTOME_PYRUVATE_METABOLISM",17,0.49773,8,9,0.22477,0.534690176678445
"283","REACTOME_ACTIVATED_TAK1_MEDIATES_P38_MAPK_ACTIVATION",16,0.51512,10,6,0.22484,0.534690176678445
"284","REACTOME_NRAGE_SIGNALS_DEATH_THROUGH_JNK",37,0.41774,24,13,0.22721,0.537337368421053
"285","REACTOME_GROWTH_HORMONE_RECEPTOR_SIGNALING",19,0.48969,13,6,0.22755,0.537337368421053
"286","REACTOME_FGFR2C_LIGAND_BINDING_AND_ACTIVATION",2,-0.80417,1,1,0.22957,0.538329651567944
"287","REACTOME_FGFR4_LIGAND_BINDING_AND_ACTIVATION",2,-0.80417,1,1,0.22957,0.538329651567944
"288","REACTOME_GABA_B_RECEPTOR_ACTIVATION",24,0.46238,16,8,0.23144,0.540024482758621
"289","REACTOME_INSULIN_SYNTHESIS_AND_PROCESSING",15,0.51961,10,5,0.23223,0.540024482758621
"290","REACTOME_INWARDLY_RECTIFYING_K_CHANNELS",16,0.5103,9,7,0.2327,0.540024482758621
"291","REACTOME_POST_CHAPERONIN_TUBULIN_FOLDING_PATHWAY",12,0.56423,8,4,0.23435,0.540197739726027
"292","REACTOME_IL_3_5_AND_GM_CSF_SIGNALING",36,0.41566,25,11,0.23438,0.540197739726027
"293","REACTOME_SYNTHESIS_OF_VERY_LONG_CHAIN_FATTY_ACYL_COAS",12,0.56405,8,4,0.23596,0.540517052980132
"294","REACTOME_CHYLOMICRON_MEDIATED_LIPID_TRANSPORT",10,0.56229,7,3,0.23671,0.540517052980132
"295","REACTOME_NA_CL_DEPENDENT_NEUROTRANSMITTER_TRANSPORTERS",4,0.71666,2,2,0.23783,0.540517052980132
"296","REACTOME_SOS_MEDIATED_SIGNALLING",14,0.52853,12,2,0.23846,0.540517052980132
"297","REACTOME_SEMA4D_INDUCED_CELL_MIGRATION_AND_GROWTH_CONE_COLLAPSE",22,0.46621,17,5,0.23876,0.540517052980132
"298","REACTOME_PRE_NOTCH_EXPRESSION_AND_PROCESSING",36,0.41053,20,16,0.24006,0.540517052980132
"299","REACTOME_UNFOLDED_PROTEIN_RESPONSE",74,0.36322,40,34,0.24181,0.540517052980132
"300","REACTOME_SIGNALING_BY_NOTCH",87,0.35654,53,34,0.24185,0.540517052980132
"301","REACTOME_G_ALPHA_Z_SIGNALLING_EVENTS",32,0.4273,21,11,0.24203,0.540517052980132
"302","REACTOME_L1CAM_INTERACTIONS",64,-0.29852,40,24,0.24255,0.540517052980132
"303","REACTOME_RNA_POL_I_TRANSCRIPTION_INITIATION",23,-0.38517,4,19,0.24355,0.540901611842105
"304","REACTOME_DOWNSTREAM_SIGNALING_OF_ACTIVATED_FGFR",74,0.36241,52,22,0.24433,0.540901611842105
"305","REACTOME_GABA_RECEPTOR_ACTIVATION",25,0.44963,16,9,0.24517,0.540981672131148
"306","REACTOME_P75NTR_SIGNALS_VIA_NFKB",12,0.55897,8,4,0.24719,0.543656437908497
"307","REACTOME_PURINE_SALVAGE",12,-0.48084,3,9,0.24802,0.543705081433225
"308","REACTOME_PROCESSING_OF_INTRONLESS_PRE_MRNAS",14,-0.45588,3,11,0.25,0.54439424437299
"309","REACTOME_THE_ACTIVATION_OF_ARYLSULFATASES",7,0.63357,5,2,0.25133,0.54439424437299
"310","REACTOME_TERMINATION_OF_O_GLYCAN_BIOSYNTHESIS",7,0.63324,4,3,0.25133,0.54439424437299
"311","REACTOME_PRE_NOTCH_PROCESSING_IN_GOLGI",16,0.50346,11,5,0.25157,0.54439424437299
"312","REACTOME_DIABETES_PATHWAYS",106,0.33632,62,44,0.25361,0.547049775641026
"313","REACTOME_SHC_MEDIATED_SIGNALLING",13,0.54486,12,1,0.25719,0.552999584664537
"314","REACTOME_RAS_ACTIVATION_UOPN_CA2_INFUX_THROUGH_NMDA_RECEPTOR",10,0.55141,8,2,0.25901,0.555139267515924
"315","REACTOME_REGULATION_OF_INSULIN_SECRETION_BY_ACETYLCHOLINE",8,0.59042,4,4,0.26117,0.55736251572327
"316","REACTOME_GRB2_EVENTS_IN_ERBB2_SIGNALING",18,0.47831,13,5,0.26217,0.55736251572327
"317","REACTOME_GABA_A_RECEPTOR_ACTIVATION",1,-0.8591,0,1,0.26336,0.55736251572327
"318","REACTOME_LIGAND_GATED_ION_CHANNEL_TRANSPORT",1,-0.8591,0,1,0.26336,0.55736251572327
"319","REACTOME_DARPP_32_EVENTS",21,0.46085,18,3,0.26758,0.564518307210031
"320","REACTOME_GABA_SYNTHESIS_RELEASE_REUPTAKE_AND_DEGRADATION",10,0.54636,7,3,0.2693,0.56521549689441
"321","REACTOME_SIGNALING_BY_ACTIVATED_POINT_MUTANTS_OF_FGFR1",3,-0.72111,1,2,0.26978,0.56521549689441
"322","REACTOME_DAG_AND_IP3_SIGNALING",25,0.44165,19,6,0.27043,0.56521549689441
"323","REACTOME_REGULATION_OF_KIT_SIGNALING",15,0.50916,10,5,0.2733,0.568518827160494
"324","REACTOME_PRE_NOTCH_TRANSCRIPTION_AND_TRANSLATION",21,0.45937,10,11,0.2737,0.568518827160494
"325","REACTOME_P53_INDEPENDENT_G1_S_DNA_DAMAGE_CHECKPOINT",45,0.38412,34,11,0.27716,0.572483527607362
"326","REACTOME_DOUBLE_STRAND_BREAK_REPAIR",22,-0.40086,6,16,0.27731,0.572483527607362
"327","REACTOME_ADP_SIGNALLING_THROUGH_P2RY12",17,0.48094,11,6,0.27829,0.572749755351682
"328","REACTOME_NUCLEAR_EVENTS_KINASE_AND_TRANSCRIPTION_FACTOR_ACTIVATION",24,0.44758,21,3,0.28093,0.574835528700906
"329","REACTOME_CLASS_I_MHC_MEDIATED_ANTIGEN_PROCESSING_PRESENTATION",210,0.31062,135,75,0.28142,0.574835528700906
"330","REACTOME_SIGNALING_BY_FGFR",83,0.34532,58,25,0.28255,0.574835528700906
"331","REACTOME_MHC_CLASS_II_ANTIGEN_PRESENTATION",71,0.35855,45,26,0.28272,0.574835528700906
"332","REACTOME_RAP1_SIGNALLING",13,0.53218,10,3,0.28435,0.57640828313253
"333","REACTOME_CELL_EXTRACELLULAR_MATRIX_INTERACTIONS",9,0.58011,8,1,0.29293,0.592017687687688
"334","REACTOME_GLUCONEOGENESIS",26,0.42995,19,7,0.29819,0.600843922155689
"335","REACTOME_HIV_INFECTION",181,0.3087,102,79,0.30549,0.613151071428572
"336","REACTOME_SIGNALING_BY_NOTCH1",59,0.37114,39,20,0.30612,0.613151071428572
"337","REACTOME_MAPK_TARGETS_NUCLEAR_EVENTS_MEDIATED_BY_MAP_KINASES",29,0.41425,24,5,0.30793,0.614946261127596
"338","REACTOME_ERK_MAPK_TARGETS",21,0.44743,19,2,0.3104,0.614951325648415
"339","REACTOME_SEMA3A_PLEXIN_REPULSION_SIGNALING_BY_INHIBITING_INTEGRIN_ADHESION",11,0.53825,9,2,0.31199,0.614951325648415
"340","REACTOME_PI3K_AKT_ACTIVATION",35,0.38963,22,13,0.31375,0.614951325648415
"341","REACTOME_HS_GAG_BIOSYNTHESIS",19,0.44863,8,11,0.31424,0.614951325648415
"342","REACTOME_REGULATION_OF_BETA_CELL_DEVELOPMENT",8,0.56366,5,3,0.31443,0.614951325648415
"343","REACTOME_COPI_MEDIATED_TRANSPORT",9,0.56312,9,0,0.31481,0.614951325648415
"344","REACTOME_METAL_ION_SLC_TRANSPORTERS",16,0.47647,7,9,0.31604,0.614951325648415
"345","REACTOME_O_LINKED_GLYCOSYLATION_OF_MUCINS",27,0.42342,15,12,0.31634,0.614951325648415
"346","REACTOME_ADHERENS_JUNCTIONS_INTERACTIONS",15,-0.43814,6,9,0.31707,0.614951325648415
"347","REACTOME_KERATAN_SULFATE_BIOSYNTHESIS",15,-0.43815,9,6,0.31707,0.614951325648415
"348","REACTOME_NFKB_IS_ACTIVATED_AND_SIGNALS_SURVIVAL",9,0.56005,6,3,0.3266,0.627905197740113
"349","REACTOME_TRAF3_DEPENDENT_IRF_ACTIVATION_PATHWAY",11,0.53133,8,3,0.32677,0.627905197740113
"350","REACTOME_PLATELET_HOMEOSTASIS",54,0.36589,32,22,0.32747,0.627905197740113
"351","REACTOME_SIGNALING_BY_NOTCH4",11,0.53045,9,2,0.32841,0.627905197740113
"352","REACTOME_TRANSCRIPTIONAL_ACTIVITY_OF_SMAD2_SMAD3_SMAD4_HETEROTRIMER",35,0.38523,17,18,0.32951,0.627905197740113
"353","REACTOME_PHASE1_FUNCTIONALIZATION_OF_COMPOUNDS",24,-0.36233,11,13,0.33016,0.627905197740113
"354","REACTOME_YAP1_AND_WWTR1_TAZ_STIMULATED_GENE_EXPRESSION",17,0.46144,10,7,0.33028,0.627905197740113
"355","REACTOME_SIGNAL_TRANSDUCTION_BY_L1",30,0.40919,23,7,0.33238,0.630117577464789
"356","REACTOME_AMINO_ACID_TRANSPORT_ACROSS_THE_PLASMA_MEMBRANE",20,0.43472,9,11,0.34121,0.645040252808989
"357","REACTOME_P75_NTR_RECEPTOR_MEDIATED_SIGNALLING",70,0.34962,47,23,0.34487,0.650133081232493
"358","REACTOME_GLUCAGON_TYPE_LIGAND_RECEPTORS",16,0.46065,10,6,0.35063,0.657346657381616
"359","REACTOME_BIOLOGICAL_OXIDATIONS",62,-0.28994,30,32,0.35065,0.657346657381616
"360","REACTOME_DEADENYLATION_OF_MRNA",18,-0.37898,5,13,0.35342,0.660699055555556
"361","REACTOME_GLUCURONIDATION",3,-0.68269,0,3,0.357,0.665542936288089
"362","REACTOME_BILE_SALT_AND_ORGANIC_ANION_SLC_TRANSPORTERS",3,0.695,1,2,0.35953,0.66721293956044
"363","REACTOME_CYTOCHROME_P450_ARRANGED_BY_SUBSTRATE_TYPE",15,-0.42271,6,9,0.36043,0.66721293956044
"364","REACTOME_AQUAPORIN_MEDIATED_TRANSPORT",32,0.39618,19,13,0.36087,0.66721293956044
"365","REACTOME_GAMMA_CARBOXYLATION_TRANSPORT_AND_AMINO_TERMINAL_CLEAVAGE_OF_PROTEINS",5,-0.5939,3,2,0.36701,0.676706109589041
"366","REACTOME_CDK_MEDIATED_PHOSPHORYLATION_AND_REMOVAL_OF_CDC6",43,0.3755,33,10,0.36938,0.679215136612022
"367","REACTOME_SYNTHESIS_OF_BILE_ACIDS_AND_BILE_SALTS_VIA_7ALPHA_HYDROXYCHOLESTEROL",9,0.53347,6,3,0.37205,0.680406657608696
"368","REACTOME_PECAM1_INTERACTIONS",9,0.53195,7,2,0.37205,0.680406657608696
"369","REACTOME_P75NTR_RECRUITS_SIGNALLING_COMPLEXES",10,0.50631,6,4,0.37736,0.686750242587601
"370","REACTOME_SIGNALING_BY_NOTCH2",11,0.50379,9,2,0.37767,0.686750242587601
"371","REACTOME_INTEGRATION_OF_ENERGY_METABOLISM",79,0.33057,48,31,0.37858,0.686750242587601
"372","REACTOME_SMOOTH_MUSCLE_CONTRACTION",21,0.42324,15,6,0.38073,0.688793790322581
"373","REACTOME_KINESINS",19,-0.36902,7,12,0.38764,0.69868168
"374","REACTOME_PASSIVE_TRANSPORT_BY_AQUAPORINS",3,0.68878,1,2,0.389,0.69868168
"375","REACTOME_MRNA_PROCESSING",150,-0.24583,50,100,0.38931,0.69868168
"376","REACTOME_ENDOSOMAL_SORTING_COMPLEX_REQUIRED_FOR_TRANSPORT_ESCRT",23,0.40787,17,6,0.39204,0.701219708994709
"377","REACTOME_ROLE_OF_SECOND_MESSENGERS_IN_NETRIN1_SIGNALING",3,-0.66288,2,1,0.39351,0.701219708994709
"378","REACTOME_SIGNALING_BY_FGFR1_MUTANTS",20,-0.36987,7,13,0.39385,0.701219708994709
"379","REACTOME_DNA_REPAIR",103,-0.25727,25,78,0.39594,0.701744184210526
"380","REACTOME_SYNTHESIS_OF_BILE_ACIDS_AND_BILE_SALTS",10,0.50049,6,4,0.39623,0.701744184210526
"381","REACTOME_GLYCOGEN_BREAKDOWN_GLYCOGENOLYSIS",16,-0.40459,11,5,0.39891,0.704636299212598
"382","REACTOME_GLUCOSE_TRANSPORT",32,0.38766,13,19,0.4029,0.709821204188482
"383","REACTOME_PROLONGED_ERK_ACTIVATION_EVENTS",18,0.4254,16,2,0.41287,0.725486971279373
"384","REACTOME_GLUCOSE_METABOLISM",56,0.33836,39,17,0.41499,0.727313203125
"385","REACTOME_ADENYLATE_CYCLASE_ACTIVATING_PATHWAY",7,-0.494,5,2,0.41648,0.728028675324675
"386","REACTOME_IRAK2_MEDIATED_ACTIVATION_OF_TAK1_COMPLEX_UPON_TLR7_8_OR_9_STIMULATION",8,0.51823,3,5,0.42096,0.733953575129534
"387","REACTOME_G_PROTEIN_ACTIVATION",19,0.41382,13,6,0.4257,0.7403
"388","REACTOME_ACYL_CHAIN_REMODELLING_OF_PS",6,0.56889,4,2,0.42857,0.743370128865979
"389","REACTOME_NETRIN1_SIGNALING",23,0.39687,13,10,0.43185,0.746460538461538
"390","REACTOME_RETROGRADE_NEUROTROPHIN_SIGNALLING",11,-0.4179,7,4,0.43257,0.746460538461538
"391","REACTOME_NCAM_SIGNALING_FOR_NEURITE_OUT_GROWTH",44,0.3479,29,15,0.43478,0.748355345268542
"392","REACTOME_SMAD2_SMAD3_SMAD4_HETEROTRIMER_REGULATES_TRANSCRIPTION",24,0.39554,11,13,0.44105,0.757210841836735
"393","REACTOME_PURINE_METABOLISM",28,-0.32729,7,21,0.44308,0.758760407124682
"394","REACTOME_GLUCAGON_SIGNALING_IN_METABOLIC_REGULATION",24,-0.33987,15,9,0.44762,0.764589492385787
"395","REACTOME_PTM_GAMMA_CARBOXYLATION_HYPUSINE_FORMATION_AND_ARYLSULFATASE_ACTIVATION",16,0.42183,10,6,0.44969,0.766180683544304
"396","REACTOME_APC_C_CDH1_MEDIATED_DEGRADATION_OF_CDC20_AND_OTHER_APC_C_CDH1_TARGETED_PROTEINS_IN_LATE_MITOSIS_EARLY_G1",61,0.32809,44,17,0.45479,0.770298975
"397","REACTOME_REGULATION_OF_HYPOXIA_INDUCIBLE_FACTOR_HIF_BY_OXYGEN",19,0.40352,15,4,0.45511,0.770298975
"398","REACTOME_PROSTACYCLIN_SIGNALLING_THROUGH_PROSTACYCLIN_RECEPTOR",15,0.44962,9,6,0.45656,0.770298975
"399","REACTOME_ACTIVATED_AMPK_STIMULATES_FATTY_ACID_OXIDATION_IN_MUSCLE",16,0.41991,9,7,0.45755,0.770298975
"400","REACTOME_COMMON_PATHWAY",6,0.55296,4,2,0.45783,0.770298975
"401","REACTOME_CLASS_B_2_SECRETIN_FAMILY_RECEPTORS",42,0.3503,24,18,0.46467,0.778185547263682
"402","REACTOME_PREFOLDIN_MEDIATED_TRANSFER_OF_SUBSTRATE_TO_CCT_TRIC",21,0.39315,10,11,0.46483,0.778185547263682
"403","REACTOME_NRIF_SIGNALS_CELL_DEATH_FROM_THE_NUCLEUS",13,0.44952,9,4,0.46645,0.778959925558313
"404","REACTOME_CGMP_EFFECTS",13,0.44825,6,7,0.46805,0.7792414004914
"405","REACTOME_SHC1_EVENTS_IN_EGFR_SIGNALING",14,0.45038,12,2,0.46923,0.7792414004914
"406","REACTOME_RNA_POL_I_RNA_POL_III_AND_MITOCHONDRIAL_TRANSCRIPTION",74,-0.27179,20,54,0.47115,0.7792414004914
"407","REACTOME_SEMA3A_PAK_DEPENDENT_AXON_REPULSION",13,0.44653,9,4,0.47125,0.7792414004914
"408","REACTOME_OPSINS",1,0.78071,1,0,0.4728,0.779888235294118
"409","REACTOME_MITOTIC_G2_G2_M_PHASES",72,-0.26567,25,47,0.47465,0.78102555012225
"410","REACTOME_ARMS_MEDIATED_ACTIVATION",16,0.41371,14,2,0.47799,0.781541570048309
"411","REACTOME_RNA_POL_III_TRANSCRIPTION_INITIATION_FROM_TYPE_2_PROMOTER",22,-0.33581,5,17,0.47899,0.781541570048309
"412","REACTOME_SIGNALING_BY_ROBO_RECEPTOR",23,0.38574,10,13,0.47933,0.781541570048309
"413","REACTOME_THROMBIN_SIGNALLING_THROUGH_PROTEINASE_ACTIVATED_RECEPTORS_PARS",26,0.3745,15,11,0.48042,0.781541570048309
"414","REACTOME_ETHANOL_OXIDATION",4,-0.56553,1,3,0.48077,0.781541570048309
"415","REACTOME_SIGNAL_AMPLIFICATION",27,0.37571,16,11,0.48576,0.787750554216868
"416","REACTOME_PEROXISOMAL_LIPID_METABOLISM",20,0.38329,11,9,0.49335,0.788450090909091
"417","REACTOME_SEROTONIN_RECEPTORS",2,0.69313,1,1,0.49385,0.788450090909091
"418","REACTOME_INTRINSIC_PATHWAY",10,0.46792,6,4,0.494,0.788450090909091
"419","REACTOME_ADP_SIGNALLING_THROUGH_P2RY1",21,0.38381,12,9,0.49541,0.788450090909091
"420","REACTOME_PEPTIDE_HORMONE_BIOSYNTHESIS",1,0.76802,1,0,0.49582,0.788450090909091
"421","REACTOME_N_GLYCAN_ANTENNAE_ELONGATION",11,-0.39969,5,6,0.49618,0.788450090909091
"422","REACTOME_TGF_BETA_RECEPTOR_SIGNALING_ACTIVATES_SMADS",24,0.3817,16,8,0.49636,0.788450090909091
"423","REACTOME_DEGRADATION_OF_THE_EXTRACELLULAR_MATRIX",16,0.40568,10,6,0.5,0.788450090909091
"424","REACTOME_OTHER_SEMAPHORIN_INTERACTIONS",12,0.44687,8,4,0.5008,0.788450090909091
"425","REACTOME_E2F_MEDIATED_REGULATION_OF_DNA_REPLICATION",32,-0.30035,9,23,0.50321,0.788450090909091
"426","REACTOME_AUTODEGRADATION_OF_CDH1_BY_CDH1_APC_C",54,0.32676,39,15,0.50338,0.788450090909091
"427","REACTOME_APOPTOSIS_INDUCED_DNA_FRAGMENTATION",10,-0.41773,3,7,0.50358,0.788450090909091
"428","REACTOME_AXON_GUIDANCE",175,0.28837,106,69,0.50519,0.788450090909091
"429","REACTOME_PROTEIN_FOLDING",45,0.33291,26,19,0.50557,0.788450090909091
"430","REACTOME_NFKB_ACTIVATION_THROUGH_FADD_RIP1_PATHWAY_MEDIATED_BY_CASPASE_8_AND10",11,0.45764,8,3,0.50575,0.788450090909091
"431","REACTOME_INHIBITION_OF_INSULIN_SECRETION_BY_ADRENALINE_NORADRENALINE",20,-0.33843,10,10,0.50769,0.788450090909091
"432","REACTOME_PACKAGING_OF_TELOMERE_ENDS",19,-0.34373,6,13,0.50843,0.788450090909091
"433","REACTOME_CELL_CELL_COMMUNICATION",77,0.30817,39,38,0.50879,0.788450090909091
"434","REACTOME_HDL_MEDIATED_LIPID_TRANSPORT",12,-0.38152,5,7,0.50923,0.788450090909091
"435","REACTOME_TGF_BETA_RECEPTOR_SIGNALING_IN_EMT_EPITHELIAL_TO_MESENCHYMAL_TRANSITION",13,-0.38061,8,5,0.51064,0.788450090909091
"436","REACTOME_PROCESSING_OF_CAPPED_INTRONLESS_PRE_MRNA",23,-0.31838,8,15,0.51289,0.788450090909091
"437","REACTOME_TRANSPORT_OF_MATURE_TRANSCRIPT_TO_CYTOPLASM",51,-0.27209,16,35,0.51351,0.788450090909091
"438","REACTOME_REGULATION_OF_GLUCOKINASE_BY_GLUCOKINASE_REGULATORY_PROTEIN",25,-0.31018,8,17,0.51368,0.788450090909091
"439","REACTOME_AMINE_COMPOUND_SLC_TRANSPORTERS",9,0.47993,5,4,0.51515,0.788450090909091
"440","REACTOME_CELL_DEATH_SIGNALLING_VIA_NRAGE_NRIF_AND_NADE",52,0.32551,32,20,0.51548,0.788450090909091
"441","REACTOME_CLEAVAGE_OF_GROWING_TRANSCRIPT_IN_THE_TERMINATION_REGION_",41,-0.28848,13,28,0.51701,0.788997120181406
"442","REACTOME_PLATELET_ADHESION_TO_EXPOSED_COLLAGEN",9,0.47587,6,3,0.52189,0.793669051918736
"443","REACTOME_DCC_MEDIATED_ATTRACTIVE_SIGNALING",12,-0.37386,6,6,0.52243,0.793669051918736
"444","REACTOME_FORMATION_OF_FIBRIN_CLOT_CLOTTING_CASCADE",18,0.38779,10,8,0.5259,0.796011121076233
"445","REACTOME_G1_PHASE",34,0.34401,20,14,0.52687,0.796011121076233
"446","REACTOME_IL_RECEPTOR_SHC_SIGNALING",21,0.37447,16,5,0.52752,0.796011121076233
"447","REACTOME_CDC6_ASSOCIATION_WITH_THE_ORC_ORIGIN_COMPLEX",11,-0.38569,1,10,0.52926,0.796850067114094
"448","REACTOME_DOWNREGULATION_OF_TGF_BETA_RECEPTOR_SIGNALING",21,0.37353,14,7,0.53058,0.797054330357143
"449","REACTOME_TRYPTOPHAN_CATABOLISM",6,0.51899,2,4,0.53184,0.797167750556793
"450","REACTOME_G_BETA_GAMMA_SIGNALLING_THROUGH_PLC_BETA",16,0.39387,10,6,0.53616,0.800183569844789
"451","REACTOME_SIGNALLING_TO_ERKS",32,0.34967,25,7,0.53623,0.800183569844789
"452","REACTOME_METABOLISM_OF_VITAMINS_AND_COFACTORS",46,0.33272,29,17,0.54092,0.804628697571744
"453","REACTOME_BASIGIN_INTERACTIONS",18,0.38179,10,8,0.5416,0.804628697571744
"454","REACTOME_NEP_NS2_INTERACTS_WITH_THE_CELLULAR_EXPORT_MACHINERY",27,-0.30901,8,19,0.54328,0.805346784140969
"455","REACTOME_PURINE_RIBONUCLEOSIDE_MONOPHOSPHATE_BIOSYNTHESIS",11,-0.3821,3,8,0.54453,0.805425692307692
"456","REACTOME_RECEPTOR_LIGAND_BINDING_INITIATES_THE_SECOND_PROTEOLYTIC_CLEAVAGE_OF_NOTCH_RECEPTOR",10,0.4482,6,4,0.54717,0.807555723684211
"457","REACTOME_NITRIC_OXIDE_STIMULATES_GUANYLATE_CYCLASE",16,0.38861,7,9,0.55503,0.816093318777293
"458","REACTOME_ABCA_TRANSPORTERS_IN_LIPID_HOMEOSTASIS",12,0.42324,8,4,0.55538,0.816093318777293
"459","REACTOME_AMINE_LIGAND_BINDING_RECEPTORS",6,0.50401,3,3,0.55938,0.820180261437908
"460","REACTOME_ASSOCIATION_OF_LICENSING_FACTORS_WITH_THE_PRE_REPLICATIVE_COMPLEX",13,-0.36343,2,11,0.56915,0.825157133891213
"461","REACTOME_REVERSIBLE_HYDRATION_OF_CARBON_DIOXIDE",6,-0.47499,4,2,0.57007,0.825157133891213
"462","REACTOME_LOSS_OF_NLP_FROM_MITOTIC_CENTROSOMES",51,-0.26458,17,34,0.57143,0.825157133891213
"463","REACTOME_LIPID_DIGESTION_MOBILIZATION_AND_TRANSPORT",29,0.34964,18,11,0.57317,0.825157133891213
"464","REACTOME_DOPAMINE_NEUROTRANSMITTER_RELEASE_CYCLE",7,0.48759,5,2,0.57345,0.825157133891213
"465","REACTOME_SIGNAL_ATTENUATION",10,0.43872,7,3,0.57461,0.825157133891213
"466","REACTOME_ANDROGEN_BIOSYNTHESIS",3,0.59967,2,1,0.57564,0.825157133891213
"467","REACTOME_ABC_FAMILY_PROTEINS_MEDIATED_TRANSPORT",21,0.36324,11,10,0.57645,0.825157133891213
"468","REACTOME_FORMATION_OF_TUBULIN_FOLDING_INTERMEDIATES_BY_CCT_TRIC",15,0.40275,6,9,0.57662,0.825157133891213
"469","REACTOME_MRNA_DECAY_BY_3_TO_5_EXORIBONUCLEASE",11,-0.37555,2,9,0.57761,0.825157133891213
"470","REACTOME_SIGNALING_BY_FGFR_IN_DISEASE",96,0.29013,61,35,0.57888,0.825157133891213
"471","REACTOME_PHOSPHOLIPASE_C_MEDIATED_CASCADE",30,0.34039,20,10,0.57917,0.825157133891213
"472","REACTOME_SIGNALING_BY_BMP",18,0.36899,9,9,0.58085,0.825157133891213
"473","REACTOME_PROCESSING_OF_CAPPED_INTRON_CONTAINING_PRE_MRNA",133,-0.23237,46,87,0.58125,0.825157133891213
"474","REACTOME_FRS2_MEDIATED_CASCADE",19,-0.32508,13,6,0.58146,0.825157133891213
"475","REACTOME_NCAM1_INTERACTIONS",20,0.35925,12,8,0.58346,0.825157133891213
"476","REACTOME_KERATAN_SULFATE_KERATIN_METABOLISM",19,0.36615,13,6,0.58514,0.825157133891213
"477","REACTOME_SYNTHESIS_OF_PA",18,0.36764,9,9,0.58556,0.825157133891213
"478","REACTOME_SYNTHESIS_OF_BILE_ACIDS_AND_BILE_SALTS_VIA_24_HYDROXYCHOLESTEROL",5,0.5173,2,3,0.58607,0.825157133891213
"479","REACTOME_DSCAM_INTERACTIONS",8,-0.41671,4,4,0.5881,0.826286638830898
"480","REACTOME_RNA_POL_I_TRANSCRIPTION",43,-0.2667,11,32,0.58966,0.826744968944099
"481","REACTOME_REGULATION_OF_INSULIN_SECRETION",58,0.30988,34,24,0.59109,0.826744968944099
"482","REACTOME_METABOLISM_OF_AMINO_ACIDS_AND_DERIVATIVES",143,-0.2276,71,72,0.5931,0.826744968944099
"483","REACTOME_REGULATION_OF_WATER_BALANCE_BY_RENAL_AQUAPORINS",31,0.34216,18,13,0.59334,0.826744968944099
"484","REACTOME_ALPHA_LINOLENIC_ACID_ALA_METABOLISM",10,0.43183,8,2,0.5952,0.827132077393075
"485","REACTOME_FANCONI_ANEMIA_PATHWAY",21,-0.32277,4,17,0.5977,0.827132077393075
"486","REACTOME_MRNA_SPLICING",104,-0.23569,36,68,0.59777,0.827132077393075
"487","REACTOME_ADENYLATE_CYCLASE_INHIBITORY_PATHWAY",10,-0.38874,7,3,0.59905,0.827132077393075
"488","REACTOME_DESTABILIZATION_OF_MRNA_BY_BRF1",16,0.37418,7,9,0.6022,0.827132077393075
"489","REACTOME_SYNTHESIS_OF_SUBSTRATES_IN_N_GLYCAN_BIOSYTHESIS",13,0.39409,7,6,0.60224,0.827132077393075
"490","REACTOME_GLUTATHIONE_CONJUGATION",18,0.3626,12,6,0.60283,0.827132077393075
"491","REACTOME_SIGNALING_BY_FGFR1_FUSION_MUTANTS",17,-0.33426,6,11,0.60345,0.827132077393075
"492","REACTOME_APC_C_CDC20_MEDIATED_DEGRADATION_OF_MITOTIC_PROTEINS",62,0.30119,43,19,0.60571,0.828542337398374
"493","REACTOME_SIGNALING_BY_NOTCH3",11,0.40507,8,3,0.61412,0.838342312373225
"494","REACTOME_SYNTHESIS_OF_PIPS_AT_THE_PLASMA_MEMBRANE",27,0.34372,18,9,0.62219,0.846103757575758
"495","REACTOME_EGFR_DOWNREGULATION",21,0.35036,14,7,0.62232,0.846103757575758
"496","REACTOME_THROMBOXANE_SIGNALLING_THROUGH_TP_RECEPTOR",19,0.35679,10,9,0.62693,0.85026847082495
"497","REACTOME_SPHINGOLIPID_DE_NOVO_BIOSYNTHESIS",22,0.35262,13,9,0.62791,0.85026847082495
"498","REACTOME_NEUROTRANSMITTER_RELEASE_CYCLE",17,0.3613,8,9,0.63303,0.85427928
"499","REACTOME_SIGNALING_BY_INSULIN_RECEPTOR",77,0.28864,47,30,0.63442,0.85427928
"500","REACTOME_CYTOSOLIC_SULFONATION_OF_SMALL_MOLECULES",9,0.43214,5,4,0.63468,0.85427928
"501","REACTOME_RECRUITMENT_OF_MITOTIC_CENTROSOME_PROTEINS_AND_COMPLEXES",57,-0.25892,20,37,0.63672,0.855314491017964
"502","REACTOME_LIPOPROTEIN_METABOLISM",20,0.34857,11,9,0.63959,0.857080645792564
"503","REACTOME_VEGF_LIGAND_RECEPTOR_INTERACTIONS",5,0.48944,3,2,0.64217,0.857080645792564
"504","REACTOME_CYCLIN_E_ASSOCIATED_EVENTS_DURING_G1_S_TRANSITION_",60,0.28815,41,19,0.64675,0.857080645792564
"505","REACTOME_TRANSPORT_OF_MATURE_MRNA_DERIVED_FROM_AN_INTRONLESS_TRANSCRIPT",32,-0.28404,10,22,0.64744,0.857080645792564
"506","REACTOME_N_GLYCAN_ANTENNAE_ELONGATION_IN_THE_MEDIAL_TRANS_GOLGI",15,-0.3403,7,8,0.6477,0.857080645792564
"507","REACTOME_TRANSPORT_OF_RIBONUCLEOPROTEINS_INTO_THE_HOST_NUCLEUS",27,-0.28621,9,18,0.64776,0.857080645792564
"508","REACTOME_SYNTHESIS_OF_PIPS_AT_THE_GOLGI_MEMBRANE",15,0.37671,10,5,0.64929,0.857080645792564
"509","REACTOME_GLUTAMATE_NEUROTRANSMITTER_RELEASE_CYCLE",9,-0.38829,4,5,0.64951,0.857080645792564
"510","REACTOME_ELEVATION_OF_CYTOSOLIC_CA2_LEVELS",4,-0.49401,3,1,0.64957,0.857080645792564
"511","REACTOME_PI_3K_CASCADE",37,0.31472,22,15,0.65077,0.857080645792564
"512","REACTOME_SIGNALING_BY_NODAL",11,0.39283,8,3,0.65353,0.85903455078125
"513","REACTOME_ACETYLCHOLINE_NEUROTRANSMITTER_RELEASE_CYCLE",5,0.47092,4,1,0.67505,0.883882062256809
"514","REACTOME_IONOTROPIC_ACTIVITY_OF_KAINATE_RECEPTORS",7,-0.38859,3,4,0.67506,0.883882062256809
"515","REACTOME_EICOSANOID_LIGAND_BINDING_RECEPTORS",12,-0.33434,6,6,0.6781,0.886103624031008
"516","REACTOME_RESOLUTION_OF_AP_SITES_VIA_THE_SINGLE_NUCLEOTIDE_REPLACEMENT_PATHWAY",11,-0.3476,2,9,0.67939,0.886103624031008
"517","REACTOME_G0_AND_EARLY_G1",23,-0.28653,10,13,0.68195,0.8873505
"518","REACTOME_SYNTHESIS_OF_PC",14,-0.32563,9,5,0.68466,0.8873505
"519","REACTOME_KERATAN_SULFATE_DEGRADATION",5,0.46797,4,1,0.68472,0.8873505
"520","REACTOME_OXYGEN_DEPENDENT_PROLINE_HYDROXYLATION_OF_HYPOXIA_INDUCIBLE_FACTOR_ALPHA",15,0.36504,12,3,0.68562,0.8873505
"521","REACTOME_ACTIVATION_OF_BH3_ONLY_PROTEINS",16,0.35174,9,7,0.69025,0.89162811900192
"522","REACTOME_ACTIVATION_OF_RAC",10,0.39155,4,6,0.69983,0.900862220113852
"523","REACTOME_TANDEM_PORE_DOMAIN_POTASSIUM_CHANNELS",3,-0.50869,2,1,0.70183,0.900862220113852
"524","REACTOME_LAGGING_STRAND_SYNTHESIS",19,-0.29151,4,15,0.70506,0.900862220113852
"525","REACTOME_REGULATION_OF_APOPTOSIS",52,0.28587,39,13,0.70525,0.900862220113852
"526","REACTOME_ROLE_OF_DCC_IN_REGULATING_APOPTOSIS",9,0.40036,4,5,0.70539,0.900862220113852
"527","REACTOME_TRANSPORT_OF_VITAMINS_NUCLEOSIDES_AND_RELATED_MOLECULES",22,0.32598,10,12,0.70543,0.900862220113852
"528","REACTOME_ACTIVATION_OF_KAINATE_RECEPTORS_UPON_GLUTAMATE_BINDING",23,0.32463,13,10,0.70904,0.902456105860113
"529","REACTOME_CALNEXIN_CALRETICULIN_CYCLE",11,0.37507,8,3,0.70936,0.902456105860113
"530","REACTOME_PKA_MEDIATED_PHOSPHORYLATION_OF_CREB",13,-0.3257,8,5,0.71277,0.902983834586466
"531","REACTOME_NEGATIVE_REGULATION_OF_THE_PI3K_AKT_NETWORK",7,0.41396,4,3,0.71327,0.902983834586466
"532","REACTOME_HORMONE_SENSITIVE_LIPASE_HSL_MEDIATED_TRIACYLGLYCEROL_HYDROLYSIS",9,0.39848,7,2,0.7138,0.902983834586466
"533","REACTOME_REGULATION_OF_INSULIN_SECRETION_BY_GLUCAGON_LIKE_PEPTIDE1",29,0.31236,16,13,0.71951,0.907541760299626
"534","REACTOME_SLBP_DEPENDENT_PROCESSING_OF_REPLICATION_DEPENDENT_HISTONE_PRE_MRNAS",11,-0.33685,5,6,0.7201,0.907541760299626
"535","REACTOME_PLATELET_CALCIUM_HOMEOSTASIS",9,0.39454,5,4,0.72391,0.910638186915888
"536","REACTOME_DIGESTION_OF_DIETARY_CARBOHYDRATE",3,-0.49274,2,1,0.73022,0.916862052238806
"537","REACTOME_ANTIVIRAL_MECHANISM_BY_IFN_STIMULATED_GENES",65,0.27933,35,30,0.7329,0.91823219330855
"538","REACTOME_TIE2_SIGNALING",13,-0.31952,8,5,0.73404,0.91823219330855
"539","REACTOME_DESTABILIZATION_OF_MRNA_BY_TRISTETRAPROLIN_TTP",16,0.33382,6,10,0.74057,0.924682022263451
"540","REACTOME_ACTIVATED_NOTCH1_TRANSMITS_SIGNAL_TO_THE_NUCLEUS",22,0.31594,16,6,0.74419,0.927481240740741
"541","REACTOME_RNA_POL_III_TRANSCRIPTION",31,-0.26194,10,21,0.74598,0.927993604436229
"542","REACTOME_PROSTANOID_LIGAND_RECEPTORS",8,-0.34078,4,4,0.74762,0.928317822878229
"543","REACTOME_SPRY_REGULATION_OF_FGF_SIGNALING",12,0.35726,9,3,0.75602,0.93701926335175
"544","REACTOME_ZINC_TRANSPORTERS",10,-0.33147,3,7,0.76372,0.943943905109489
"545","REACTOME_SIGNALLING_TO_P38_VIA_RIT_AND_RIN",13,0.34139,11,2,0.76518,0.943943905109489
"546","REACTOME_RNA_POL_III_TRANSCRIPTION_TERMINATION",17,-0.29395,5,12,0.76724,0.943943905109489
"547","REACTOME_INTERACTIONS_OF_VPR_WITH_HOST_CELLULAR_PROTEINS",31,-0.25775,11,20,0.76849,0.943943905109489
"548","REACTOME_P38MAPK_EVENTS",13,-0.30773,9,4,0.76862,0.943943905109489
"549","REACTOME_DOWNREGULATION_OF_SMAD2_3_SMAD4_TRANSCRIPTIONAL_ACTIVITY",19,0.30735,11,8,0.7709,0.945019489981785
"550","REACTOME_REGULATION_OF_MITOTIC_CELL_CYCLE",74,0.26378,49,25,0.7733,0.946238
"551","REACTOME_GAP_JUNCTION_ASSEMBLY",3,-0.45777,2,1,0.7789,0.951278806509946
"552","REACTOME_MTORC1_MEDIATED_SIGNALLING",11,-0.31509,3,8,0.78117,0.951278806509946
"553","REACTOME_SIGNALLING_TO_RAS",24,0.29632,18,6,0.78166,0.951278806509946
"554","REACTOME_APOPTOSIS",128,0.25182,85,43,0.78555,0.954287274368231
"555","REACTOME_GAP_JUNCTION_TRAFFICKING",12,0.33646,9,3,0.80096,0.970850917266187
"556","REACTOME_ACYL_CHAIN_REMODELLING_OF_PG",6,0.38347,3,3,0.80207,0.970850917266187
"557","REACTOME_CRMPS_IN_SEMA3A_SIGNALING",10,-0.31131,7,3,0.81146,0.980453464991023
"558","REACTOME_PI_METABOLISM",43,0.26971,26,17,0.8132,0.980794982078853
"559","REACTOME_SYNTHESIS_OF_PIPS_AT_THE_LATE_ENDOSOME_MEMBRANE",10,-0.30784,4,6,0.81862,0.984907308377897
"560","REACTOME_CHROMOSOME_MAINTENANCE",81,-0.21909,24,57,0.81991,0.984907308377897
"561","REACTOME_PURINE_CATABOLISM",6,0.37364,1,5,0.821,0.984907308377897
"562","REACTOME_ABACAVIR_TRANSPORT_AND_METABOLISM",4,-0.38232,1,3,0.82692,0.988905724381625
"563","REACTOME_MITOCHONDRIAL_FATTY_ACID_BETA_OXIDATION",12,-0.29349,5,7,0.8285,0.988905724381625
"564","REACTOME_INCRETIN_SYNTHESIS_SECRETION_AND_INACTIVATION",9,-0.31309,6,3,0.83088,0.988905724381625
"565","REACTOME_SYNTHESIS_SECRETION_AND_INACTIVATION_OF_GLP1",9,-0.31309,6,3,0.83088,0.988905724381625
"566","REACTOME_FACTORS_INVOLVED_IN_MEGAKARYOCYTE_DEVELOPMENT_AND_PLATELET_PRODUCTION",90,-0.21909,48,42,0.83168,0.988905724381625
"567","REACTOME_MEIOTIC_SYNAPSIS",38,0.27244,16,22,0.83402,0.989831338028169
"568","REACTOME_SYNTHESIS_SECRETION_AND_INACTIVATION_OF_GIP",7,0.35059,5,2,0.8354,0.989831338028169
"569","REACTOME_SYNTHESIS_OF_PE",9,0.34853,4,5,0.83838,0.990372631578947
"570","REACTOME_RNA_POL_III_CHAIN_ELONGATION",16,-0.28084,5,11,0.8388,0.990372631578947
"571","REACTOME_DESTABILIZATION_OF_MRNA_BY_KSRP",17,-0.2709,5,12,0.8477,0.997487185314685
"572","REACTOME_NOREPINEPHRINE_NEUROTRANSMITTER_RELEASE_CYCLE",7,0.34756,4,3,0.84779,0.997487185314685
"573","REACTOME_ACETYLCHOLINE_BINDING_AND_DOWNSTREAM_EVENTS",3,-0.41295,1,2,0.85193,1
"574","REACTOME_GLOBAL_GENOMIC_NER_GG_NER",32,-0.23711,7,25,0.86218,1
"575","REACTOME_POST_TRANSLATIONAL_PROTEIN_MODIFICATION",137,0.23431,69,68,0.86667,1
"576","REACTOME_GAP_JUNCTION_DEGRADATION",9,0.33011,7,2,0.87037,1
"577","REACTOME_G1_S_SPECIFIC_TRANSCRIPTION",17,-0.2614,4,13,0.88218,1
"578","REACTOME_SYNTHESIS_OF_PIPS_AT_THE_EARLY_ENDOSOME_MEMBRANE",12,0.29975,6,6,0.88604,1
"579","REACTOME_REGULATION_OF_THE_FANCONI_ANEMIA_PATHWAY",7,0.32473,3,4,0.88673,1
"580","REACTOME_IL_7_SIGNALING",11,0.30206,7,4,0.88834,1
"581","REACTOME_TRANSCRIPTION_COUPLED_NER_TC_NER",43,-0.22818,11,32,0.8931,1
"582","REACTOME_ACTIVATION_OF_GENES_BY_ATF4",23,0.26762,7,16,0.89587,1
"583","REACTOME_INTEGRATION_OF_PROVIRUS",8,0.30282,3,5,0.89691,1
"584","REACTOME_FORMATION_OF_TRANSCRIPTION_COUPLED_NER_TC_NER_REPAIR_COMPLEX",28,-0.2381,7,21,0.90154,1
"585","REACTOME_ELONGATION_ARREST_AND_RECOVERY",27,0.26019,13,14,0.90255,1
"586","REACTOME_POL_SWITCHING",13,-0.25987,3,10,0.90426,1
"587","REACTOME_N_GLYCAN_TRIMMING_IN_THE_ER_AND_CALNEXIN_CALRETICULIN_CYCLE",13,0.28343,8,5,0.90895,1
"588","REACTOME_REPAIR_SYNTHESIS_FOR_GAP_FILLING_BY_DNA_POL_IN_TC_NER",14,-0.25309,4,10,0.90909,1
"589","REACTOME_SYNTHESIS_AND_INTERCONVERSION_OF_NUCLEOTIDE_DI_AND_TRIPHOSPHATES",16,0.26258,8,8,0.91038,1
"590","REACTOME_INTRINSIC_PATHWAY_FOR_APOPTOSIS",29,0.25402,18,11,0.91159,1
"591","REACTOME_HORMONE_LIGAND_BINDING_RECEPTORS",1,-0.53688,0,1,0.91221,1
"592","REACTOME_POST_TRANSLATIONAL_MODIFICATION_SYNTHESIS_OF_GPI_ANCHORED_PROTEINS",24,-0.23258,11,13,0.91429,1
"593","REACTOME_APOBEC3G_MEDIATED_RESISTANCE_TO_HIV1_INFECTION",5,-0.30837,2,3,0.91959,1
"594","REACTOME_SULFUR_AMINO_ACID_METABOLISM",20,-0.22395,9,11,0.92308,1
"595","REACTOME_BASE_FREE_SUGAR_PHOSPHATE_REMOVAL_VIA_THE_SINGLE_NUCLEOTIDE_REPLACEMENT_PATHWAY",9,-0.27255,2,7,0.92402,1
"596","REACTOME_PHASE_II_CONJUGATION",38,0.24128,19,19,0.92593,1
"597","REACTOME_PRESYNAPTIC_NICOTINIC_ACETYLCHOLINE_RECEPTORS",2,0.39683,1,1,0.92828,1
"598","REACTOME_TRANSPORT_TO_THE_GOLGI_AND_SUBSEQUENT_MODIFICATION",30,0.23875,16,14,0.92867,1
"599","REACTOME_VIRAL_MESSENGER_RNA_SYNTHESIS",14,0.2599,6,8,0.92923,1
"600","REACTOME_RECRUITMENT_OF_NUMA_TO_MITOTIC_CENTROSOMES",9,-0.26677,5,4,0.93137,1
"601","REACTOME_BASE_EXCISION_REPAIR",18,-0.22768,4,14,0.93151,1
"602","REACTOME_ABORTIVE_ELONGATION_OF_HIV1_TRANSCRIPT_IN_THE_ABSENCE_OF_TAT",19,0.24562,9,10,0.93189,1
"603","REACTOME_MRNA_SPLICING_MINOR_PATHWAY",41,-0.21573,15,26,0.93537,1
"604","REACTOME_STEROID_HORMONES",12,0.26792,6,6,0.93579,1
"605","REACTOME_INHIBITION_OF_REPLICATION_INITIATION_OF_DAMAGED_DNA_BY_RB1_E2F1",11,-0.24891,5,6,0.93639,1
"606","REACTOME_CYTOSOLIC_TRNA_AMINOACYLATION",23,-0.22784,7,16,0.93696,1
"607","REACTOME_SIGNALING_BY_TGF_BETA_RECEPTOR_COMPLEX",58,0.22949,31,27,0.93792,1
"608","REACTOME_ACTIVATION_OF_THE_AP1_FAMILY_OF_TRANSCRIPTION_FACTORS",9,-0.264,6,3,0.93873,1
"609","REACTOME_DEADENYLATION_DEPENDENT_MRNA_DECAY",41,-0.21354,14,27,0.93878,1
"610","REACTOME_METABOLISM_OF_STEROID_HORMONES_AND_VITAMINS_A_AND_D",13,0.26277,6,7,0.9393,1
"611","REACTOME_PROCESSIVE_SYNTHESIS_ON_THE_LAGGING_STRAND",15,-0.24561,3,12,0.94038,1
"612","REACTOME_NEPHRIN_INTERACTIONS",16,-0.23762,5,11,0.94262,1
"613","REACTOME_RNA_POL_III_TRANSCRIPTION_INITIATION_FROM_TYPE_3_PROMOTER",25,-0.20458,10,15,0.94529,1
"614","REACTOME_REGULATION_OF_AMPK_ACTIVITY_VIA_LKB1",12,0.25751,6,6,0.94543,1
"615","REACTOME_METABOLISM_OF_POLYAMINES",15,0.25885,6,9,0.94787,1
"616","REACTOME_ASSOCIATION_OF_TRIC_CCT_WITH_TARGET_PROTEINS_DURING_BIOSYNTHESIS",26,0.23939,13,13,0.9488,1
"617","REACTOME_MICRORNA_MIRNA_BIOGENESIS",18,-0.21531,7,11,0.95342,1
"618","REACTOME_PERK_REGULATED_GENE_EXPRESSION",26,0.23241,9,17,0.95633,1
"619","REACTOME_FORMATION_OF_INCISION_COMPLEX_IN_GG_NER",20,-0.20874,4,16,0.96308,1
"620","REACTOME_PHOSPHORYLATION_OF_THE_APC_C",17,0.2326,8,9,0.9633,1
"621","REACTOME_CYCLIN_A_B1_ASSOCIATED_EVENTS_DURING_G2_M_TRANSITION",15,-0.21812,7,8,0.96477,1
"622","REACTOME_MRNA_DECAY_BY_5_TO_3_EXORIBONUCLEASE",12,0.2448,7,5,0.96629,1
"623","REACTOME_MRNA_CAPPING",28,-0.21549,8,20,0.96923,1
"624","REACTOME_FORMATION_OF_THE_HIV1_EARLY_ELONGATION_COMPLEX",28,-0.21549,9,19,0.96923,1
"625","REACTOME_G2_M_DNA_DAMAGE_CHECKPOINT",9,-0.24088,3,6,0.97059,1
"626","REACTOME_CONVERSION_FROM_APC_C_CDC20_TO_APC_C_CDH1_IN_LATE_ANAPHASE",16,0.21979,8,8,0.9717,1
"627","REACTOME_REGULATION_OF_RHEB_GTPASE_ACTIVITY_BY_AMPK",8,0.22984,4,4,0.97251,1
"628","REACTOME_PI3K_CASCADE",47,-0.18482,20,27,0.97436,1
"629","REACTOME_CDT1_ASSOCIATION_WITH_THE_CDC6_ORC_ORIGIN_COMPLEX",51,0.20682,33,18,0.97577,1
"630","REACTOME_ACTIVATION_OF_CHAPERONES_BY_ATF6_ALPHA",11,-0.20444,5,6,0.97964,1
"631","REACTOME_VITAMIN_B5_PANTOTHENATE_METABOLISM",11,-0.20518,6,5,0.97964,1
"632","REACTOME_INHIBITION_OF_THE_PROTEOLYTIC_ACTIVITY_OF_APC_C_REQUIRED_FOR_THE_ONSET_OF_ANAPHASE_BY_MITOTIC_SPINDLE_CHECKPOINT_COMPONENTS",18,0.20021,8,10,0.98116,1
"633","REACTOME_ENERGY_DEPENDENT_REGULATION_OF_MTOR_BY_LKB1_AMPK",15,0.22998,7,8,0.9842,1
"634","REACTOME_REGULATORY_RNA_PATHWAYS",21,-0.21537,7,14,0.98563,1
"635","REACTOME_MITOTIC_PROMETAPHASE",82,-0.1757,38,44,0.98624,1
"636","REACTOME_APC_C_CDC20_MEDIATED_DEGRADATION_OF_CYCLIN_B",19,0.20342,9,10,0.98916,1
"637","REACTOME_ORC1_REMOVAL_FROM_CHROMATIN",62,0.1816,37,25,0.98962,1
"638","REACTOME_RESOLUTION_OF_AP_SITES_VIA_THE_MULTIPLE_NUCLEOTIDE_PATCH_REPLACEMENT_PATHWAY",16,0.18221,4,12,0.99057,1
"639","REACTOME_ANTIGEN_PROCESSING_UBIQUITINATION_PROTEASOME_DEGRADATION",180,0.19726,110,70,0.99098,1
"640","REACTOME_TRANSCRIPTION",154,-0.18389,53,101,0.99254,1
"641","REACTOME_SIGNALING_BY_CONSTITUTIVELY_ACTIVE_EGFR",15,-0.16282,9,6,0.99458,1
"642","REACTOME_MEMBRANE_BINDING_AND_TARGETTING_OF_GAG_PROTEINS",8,-0.20001,4,4,0.99524,1
"643","REACTOME_APC_CDC20_MEDIATED_DEGRADATION_OF_NEK2A",21,0.1746,10,11,0.99541,1
"644","REACTOME_PKB_MEDIATED_EVENTS",26,0.19062,9,17,0.99548,1
"645","REACTOME_BIOSYNTHESIS_OF_THE_N_GLYCAN_PRECURSOR_DOLICHOL_LIPID_LINKED_OLIGOSACCHARIDE_LLO_AND_TRANSFER_TO_A_NASCENT_PROTEIN",27,0.17977,9,18,0.9955,1
"646","REACTOME_REMOVAL_OF_THE_FLAP_INTERMEDIATE_FROM_THE_C_STRAND",10,0.19614,3,7,0.99657,1
"647","REACTOME_RNA_POL_II_TRANSCRIPTION_PRE_INITIATION_AND_PROMOTER_OPENING",39,-0.16015,15,24,0.99684,1
"648","REACTOME_FORMATION_OF_RNA_POL_II_ELONGATION_COMPLEX_",38,0.18845,13,25,0.99863,1
"649","REACTOME_MITOCHONDRIAL_PROTEIN_IMPORT",47,0.1665,18,29,0.99863,1
"650","REACTOME_ASPARAGINE_N_LINKED_GLYCOSYLATION",75,0.15867,36,39,0.99869,1
"651","REACTOME_RNA_POL_I_PROMOTER_OPENING",19,0.17048,7,12,1,1
"652","REACTOME_HIV_LIFE_CYCLE",108,0.1704,43,65,1,1
"653","REACTOME_ASSEMBLY_OF_THE_PRE_REPLICATIVE_COMPLEX",60,0.15022,34,26,1,1
"654","REACTOME_SYNTHESIS_OF_DNA",87,0.14438,41,46,1,1
"655","REACTOME_MITOTIC_G1_G1_S_PHASES",126,0.13946,63,63,1,1
"656","REACTOME_DNA_REPLICATION",180,0.1381,83,97,1,1
"657","REACTOME_CELL_CYCLE_CHECKPOINTS",108,0.13201,56,52,1,1
"658","REACTOME_METABOLISM_OF_PROTEINS",366,0.12135,154,212,1,1
"659","REACTOME_METABOLISM_OF_MRNA",197,0.10684,72,125,1,1
"660","REACTOME_LATE_PHASE_OF_HIV_LIFE_CYCLE",95,-0.11424,37,58,1,1
"661","REACTOME_CELL_CYCLE_MITOTIC",293,-0.11903,130,163,1,1
"662","REACTOME_G1_S_TRANSITION",102,-0.12009,49,53,1,1
"663","REACTOME_CELL_CYCLE",348,-0.12627,150,198,1,1
"664","REACTOME_MEIOSIS",61,-0.13432,22,39,1,1
"665","REACTOME_RNA_POL_II_PRE_TRANSCRIPTION_EVENTS",54,-0.13875,22,32,1,1
"666","REACTOME_METABOLISM_OF_RNA",240,-0.13891,85,155,1,1
"667","REACTOME_RNA_POL_II_TRANSCRIPTION",95,-0.13923,36,59,1,1
"668","REACTOME_MITOTIC_M_M_G1_PHASES",160,-0.14136,76,84,1,1
"669","REACTOME_S_PHASE",103,-0.14146,46,57,1,1
"670","REACTOME_M_G1_TRANSITION",74,-0.16226,35,39,1,1
"671","REACTOME_NUCLEOTIDE_EXCISION_REPAIR",48,-0.16554,14,34,1,1
"672","REACTOME_INSULIN_RECEPTOR_SIGNALLING_CASCADE",61,-0.16832,32,29,1,1
"673","REACTOME_ACTIVATION_OF_CHAPERONE_GENES_BY_ATF6_ALPHA",9,-0.19371,4,5,1,1
